11111111111111111111111111111111
1   5                          1
1         P            11      1
1 11          111       1      1
1                              1
1                              1
1   11111111    5    11111111  1
1   1     2      2          1  1
1   1              2        1  1
1   1       3               1  1
1   1              3        1  1
1   1   3                   1  1
1   1        3        2     1   4
1       5       1      5        4
1  21       M    3          1  1
1   1                       1  1
1   1    2    5             1  1
1   1           3           1  1
1   1                       1  1
1   1                       1  1
1  211111111    5    11111111  1
1         3                    1
11111        5     2     3     1
1             11               1
11111111111111111111111111111111