1111111111111111111111111
1MMMMMMMMMMMMMMMMMMMMMMM1
1MMMMMMMMMMMMMMMMMMMMMMM1
1MMMMMMMMMMMMMMMMMMMMMMM1
1MMMMMMMMMMMMMMMMMMMMMMM1
1MMMMMMMMMMMMMMMMMMMMMMM1
1MMMMMMMMMMMMMMMMMMMMMMM1
1MMMMMMMMMMMMMMMMMMMMMMM1
1MMMMMMMMMMMMMMMMMMMMMMM1
1MMMMMMMMMMPMMMMMMMMMMMM1
1MMMMMMMMMMMMMMMMMMMMMMM1
1MMMMMMMMMMMMMMMMMMMMMMM1
1MMMMMMMMMMMMMMMMMMMMMMM1
1MMMMMMMMMMMMMMMMMMMMMMM1
1MMMMMMMMMMMMMMMMMMMMMMM1
1MMMMMMMMMMMMMMMMMMMMMMM1
1MMMMMMMMMMMMMMMMMMMMMMM1
1MMMMMMMMMMMMMMMMMMMMMMM1
1111111111111111111111111