1111111111111111111111111
1P...........111........1
1.......2........111111.1
1..11111....11111111.11.1
1..1.....2......2....1141
1..1........1......2..111
1..1...22222222..21....11..1
1..1......11.1....3..1..1
1...3...1...11111....1..1
1......2..12...2..2.....1
1.......2....2...1111...1
1.21.11111.M....3....1..1
1..1..11111....2.....1..1
1..1....2.....2...11.1..1
1..1..1111...2..2....1..1
1.211111..2....2.11111..1
1...03.....11111........1
1.....111......2.....3..1
1111111111111111111111111